"filename", "language", "Java", "comment", "blank", "total"
"c:\Users\oztur\OneDrive\Masaüstü\Projeler\blog-app-main\backend\src\main\java\com\blogapp\backend\BackendApplication.java", "Java", 9, 0, 5, 14
"c:\Users\oztur\OneDrive\Masaüstü\Projeler\blog-app-main\backend\src\main\java\com\blogapp\backend\controller\AuthController.java", "Java", 62, 1, 17, 80
"c:\Users\oztur\OneDrive\Masaüstü\Projeler\blog-app-main\backend\src\main\java\com\blogapp\backend\controller\CommentController.java", "Java", 36, 0, 8, 44
"c:\Users\oztur\OneDrive\Masaüstü\Projeler\blog-app-main\backend\src\main\java\com\blogapp\backend\controller\FollowController.java", "Java", 54, 0, 12, 66
"c:\Users\oztur\OneDrive\Masaüstü\Projeler\blog-app-main\backend\src\main\java\com\blogapp\backend\controller\PostController.java", "Java", 68, 1, 10, 79
"c:\Users\oztur\OneDrive\Masaüstü\Projeler\blog-app-main\backend\src\main\java\com\blogapp\backend\controller\UserController.java", "Java", 59, 0, 16, 75
"c:\Users\oztur\OneDrive\Masaüstü\Projeler\blog-app-main\backend\src\main\java\com\blogapp\backend\dto\CommentDto.java", "Java", 11, 1, 7, 19
"c:\Users\oztur\OneDrive\Masaüstü\Projeler\blog-app-main\backend\src\main\java\com\blogapp\backend\dto\LoginDto.java", "Java", 7, 0, 2, 9
"c:\Users\oztur\OneDrive\Masaüstü\Projeler\blog-app-main\backend\src\main\java\com\blogapp\backend\dto\PostDto.java", "Java", 12, 0, 5, 17
"c:\Users\oztur\OneDrive\Masaüstü\Projeler\blog-app-main\backend\src\main\java\com\blogapp\backend\dto\RegisterDto.java", "Java", 10, 0, 3, 13
"c:\Users\oztur\OneDrive\Masaüstü\Projeler\blog-app-main\backend\src\main\java\com\blogapp\backend\dto\UserDto.java", "Java", 21, 0, 5, 26
"c:\Users\oztur\OneDrive\Masaüstü\Projeler\blog-app-main\backend\src\main\java\com\blogapp\backend\enums\UserRole.java", "Java", 5, 0, 2, 7
"c:\Users\oztur\OneDrive\Masaüstü\Projeler\blog-app-main\backend\src\main\java\com\blogapp\backend\exception\CustomNotFoundException.java", "Java", 6, 0, 1, 7
"c:\Users\oztur\OneDrive\Masaüstü\Projeler\blog-app-main\backend\src\main\java\com\blogapp\backend\model\Comment.java", "Java", 25, 0, 6, 31
"c:\Users\oztur\OneDrive\Masaüstü\Projeler\blog-app-main\backend\src\main\java\com\blogapp\backend\model\Follow.java", "Java", 22, 0, 7, 29
"c:\Users\oztur\OneDrive\Masaüstü\Projeler\blog-app-main\backend\src\main\java\com\blogapp\backend\model\FollowId.java", "Java", 6, 1, 7, 14
"c:\Users\oztur\OneDrive\Masaüstü\Projeler\blog-app-main\backend\src\main\java\com\blogapp\backend\model\Post.java", "Java", 25, 0, 6, 31
"c:\Users\oztur\OneDrive\Masaüstü\Projeler\blog-app-main\backend\src\main\java\com\blogapp\backend\model\PostLog.java", "Java", 25, 0, 6, 31
"c:\Users\oztur\OneDrive\Masaüstü\Projeler\blog-app-main\backend\src\main\java\com\blogapp\backend\model\Role.java", "Java", 15, 0, 6, 21
"c:\Users\oztur\OneDrive\Masaüstü\Projeler\blog-app-main\backend\src\main\java\com\blogapp\backend\model\User.java", "Java", 29, 0, 6, 35
"c:\Users\oztur\OneDrive\Masaüstü\Projeler\blog-app-main\backend\src\main\java\com\blogapp\backend\repository\CommentRepository.java", "Java", 7, 0, 4, 11
"c:\Users\oztur\OneDrive\Masaüstü\Projeler\blog-app-main\backend\src\main\java\com\blogapp\backend\repository\FollowRepository.java", "Java", 9, 0, 5, 14
"c:\Users\oztur\OneDrive\Masaüstü\Projeler\blog-app-main\backend\src\main\java\com\blogapp\backend\repository\PostRepository.java", "Java", 9, 0, 4, 13
"c:\Users\oztur\OneDrive\Masaüstü\Projeler\blog-app-main\backend\src\main\java\com\blogapp\backend\repository\RoleRepository.java", "Java", 8, 0, 4, 12
"c:\Users\oztur\OneDrive\Masaüstü\Projeler\blog-app-main\backend\src\main\java\com\blogapp\backend\repository\UserRepository.java", "Java", 11, 0, 6, 17
"c:\Users\oztur\OneDrive\Masaüstü\Projeler\blog-app-main\backend\src\main\java\com\blogapp\backend\service\CommentService.java", "Java", 55, 1, 15, 71
"c:\Users\oztur\OneDrive\Masaüstü\Projeler\blog-app-main\backend\src\main\java\com\blogapp\backend\service\FollowService.java", "Java", 22, 0, 6, 28
"c:\Users\oztur\OneDrive\Masaüstü\Projeler\blog-app-main\backend\src\main\java\com\blogapp\backend\service\PostService.java", "Java", 55, 2, 19, 76
"c:\Users\oztur\OneDrive\Masaüstü\Projeler\blog-app-main\backend\src\main\java\com\blogapp\backend\service\UserService.java", "Java", 42, 5, 11, 58
"Total", "-", 725, 12, 211, 948